{
  "name": "bfs_hopcost01",
  "width": 12,
  "height": 13,
  "rows": [
    "............",
    "....#.......",
    "............",
    "...#........",
    "............",
    "............",
    "............",
    "............",
    "............",
    "............",
    "............",
    "............",
    "............"
  ]
}
