{
  "name": "dstar_trap01",
  "width": 17,
  "height": 17,
  "resolution": 0.5,
  "origin": [0.0, 0.0],
  "rows": [
    ".................",
    ".................",
    ".................",
    ".................",
    ".....########....",
    "............#....",
    "............#....",
    "............#....",
    "............#....",
    "............#....",
    "............#....",
    "............#....",
    ".....########....",
    ".................",
    ".................",
    ".................",
    "................."
  ]
}
