{
  "name": "open01",
  "width": 20,
  "height": 20,
  "rows": [
    "####################",
    "#..................#",
    "#..................#",
    "#..................#",
    "#....####..........#",
    "#....####..........#",
    "#....####....###...#",
    "#....####....###...#",
    "#....####....###...#",
    "#............###...#",
    "#..................#",
    "#..........#####...#",
    "#..........#####...#",
    "#..........#####...#",
    "#..........#####...#",
    "#..........#####...#",
    "#..................#",
    "#..................#",
    "#..................#",
    "####################"
  ]
}
