{
  "name": "pf_trap01",
  "width": 20,
  "height": 20,
  "resolution": 0.5,
  "origin": [0.0, 0.0],
  "rows": [
    "....................",
    "....................",
    "....................",
    "....................",
    "....................",
    "....................",
    "........########....",
    "...............#....",
    "...............#....",
    "...............#....",
    "...............#....",
    "...............#....",
    "...............#....",
    "...............#....",
    "........########....",
    "....................",
    "....................",
    "....................",
    "....................",
    "...................."
  ]
}
