{
  "name": "wastar_greedy01",
  "width": 13,
  "height": 14,
  "rows": [
    ".............",
    "..........#..",
    "...........#.",
    ".............",
    ".............",
    ".............",
    ".............",
    ".............",
    ".............",
    ".............",
    ".............",
    ".............",
    ".............",
    "............."
  ]
}
